30 21 tileset00.png 2 0 2
2 2 2 2 2 2 2 2 2 2 2 2 2 2 2 2 2 2 2 2 2 2 2 2 2 2 2 2 2 2
2 2 2 1 1 1 1 1 1 1 2 2 2 2 2 2 2 2 2 2 2 2 2 2 2 2 2 2 2 2
2 2 1 1 1 1 1 1 1 1 1 2 2 2 2 2 2 2 1 1 1 2 2 2 2 2 2 2 2 2
2 1 1 1 1 1 1 1 1 1 1 2 1 1 1 2 2 1 1 1 3 1 1 1 1 2 2 2 2 2
2 1 1 3 1 1 1 1 1 1 1 1 1 1 3 1 1 1 1 3 3 1 1 1 1 1 2 2 2 2
2 1 1 3 1 1 1 1 1 1 1 1 1 3 3 3 1 1 1 3 1 1 1 1 1 1 1 2 2 2
2 1 1 3 3 3 3 3 3 3 3 1 1 1 1 3 1 3 3 3 1 1 1 1 1 1 1 2 2 2
2 1 3 3 1 1 1 1 1 1 3 3 1 1 1 3 3 3 1 1 1 1 1 1 1 1 2 2 2 2
2 1 3 1 1 2 2 2 1 1 1 3 3 3 3 3 1 1 1 1 1 1 1 1 1 1 2 2 2 2
2 1 3 1 2 2 2 2 1 1 1 1 1 1 1 1 1 1 1 1 1 1 1 1 1 1 1 2 2 2
2 1 3 1 2 2 2 2 1 1 1 1 1 1 1 1 1 1 1 1 1 1 1 1 1 1 1 2 2 2
2 1 3 1 2 2 2 1 1 1 3 1 1 1 1 1 1 1 1 1 1 1 1 1 1 1 1 1 2 2
2 1 3 1 1 2 2 1 1 3 3 1 1 1 1 1 1 1 1 1 1 1 1 1 1 1 1 1 2 2
2 1 3 3 1 1 1 1 3 3 1 1 1 1 1 1 1 1 1 1 1 1 1 1 1 1 1 2 2 2
2 1 1 3 3 3 3 3 3 1 1 1 1 1 1 1 1 1 1 2 2 2 1 1 2 1 2 2 2 2
2 1 1 1 1 1 1 1 1 1 1 1 1 1 1 1 1 1 2 2 2 2 2 2 2 2 2 2 2 2
2 2 1 1 1 1 2 1 1 1 1 1 1 1 1 1 1 2 2 2 2 2 2 2 2 2 2 2 2 2
2 2 1 1 1 2 2 2 2 1 1 1 1 2 1 1 2 2 2 2 2 2 2 2 2 2 2 2 2 2
2 2 2 2 2 2 2 2 2 2 1 2 2 2 2 2 2 2 2 2 2 2 2 2 2 2 2 2 2 2
2 2 2 2 2 2 2 2 2 2 2 2 2 2 2 2 2 2 2 2 2 2 2 2 2 2 2 2 2 2
2 2 2 2 2 2 2 2 2 2 2 2 2 2 2 2 2 2 2 2 2 2 2 2 2 2 2 2 2 2
3 4
24
1 5 5 "This text is written in map file"
1 7 5 "@msg_loc_file"
1 9 5 "@msg_lost_localization"
2 10 11 2 5 5
2 20 3 80 5 5
1 20 5 "This portal leads to 80th screen, which is not exist."
2 14 4 0 5 5
1 14 6 "This portal leads to 0th screen, which is s_MAIN_MENU and should not open from map portal."
3 8 9 2
3 14 10 4
3 9 10 2
3 10 10 3
3 2 2 7
3 1 3 1
3 11 4 3
3 12 6 4
3 13 6 6
3 14 11 6
3 7 11 7
3 3 17 3
3 3 16 4
3 16 4 7
3 17 3 3
3 21 4 2